00100010000111111111
10101010000111111111
10101010100111111111
10101010100111111111
10101010100000000000
10101010100000000000
10101010111111111100
10101010111111111100
10101010100000000000
10101010100000000000
10101010100111111111
10101010100111111111
10001000100000000000
